NO ./textures/north.xpm
SO ./textures/south.xpm
WE ./textures/west2.xpm
EA ./textures/east2.xpm

F     0,141,98
 
    
C 9,205,255

        1111111111111111111111111
        1000000000110000000000001
        1011000001110000000000001
        1001000000000000000000001
111111111011000001110000000000001
100000000011000001110111111111111
1111011111111101110000001001
11110111111111011101010010001
11000000110101011100000010001
100000000000000011000N0010001
10000000000000001101010010001
11000001110101011111011110001111111111111
11110111 1110101 101111010001
11111111 1111111 111111111111