NO ./textures/north.xpm
SO ./textures/south.xpm
WE ./textures/west.xpm
EA ./textures/east.xpm

F 220,100,0

C 225,30,0

        1111111111111111111111111
        1000000000110000000000001
        1011000001110000000000001
        1001000000000000000000001
111111111011000001110000000000001
10000000001100000111011101110001
111101111111110111000000100010001
111101111111110111010100100010001
110000001101010111000000100010001
100000000000000011000000100010001
100000000000000011010100100010001
11000001110101011111011110N01111111111111
11110111 1110101 101111010001
11111111 1111111 111111111111
