NO ./textures/chulsu.xpm
SO ./textures/maengju.xpm
WE ./textures/yuri.xpm
EA ./textures/jjanggu.xpm

F     0,255,255
C                         9,205,255

1111111111111111111111111111111111111111111
1000000000000000000000000000000000000000001
1000000000000000000000000000000000000000001
1000000000000000000000000000000000000000001
1000000000000000000000000000000000000000001
1000000000000000000000000000000000000000001
10000000000000000000100000000000000000000011
1000000000000000000000000000000000000000001
1000000010000000000000000111111111111111111
1000000000000000000000011111
100000000000000000000000000111111111111111111
10000000001000W0000000000000000000000000001
100000000000000000000000000000000000000000111
1000000000000000000000000000000000000000001
1000000000000000000000000001000000000000001
1000000000000000000010000000000000000000001
1000000000000000000000001000000000000000001
1111111111111111111111111111111111111111111