NO ./textures/chulsu.xpm
SO ./textures/maengju.xpm
WE ./textures/yuri.xpm
EA ./textures/jjanggu.xpm

F     0,141,98
C 9,205,255

1111111111111111111111111111111111111111111
1000000000000000000000000000000000000000001
1000000000000000000000000000000000000000001
1000000000000000000000000000000000000000001
1000000000000000000000000000000000000000001
1000000000000000000000000000000000000000001
1000000000000000000010000000000000000000001
1000000000000000000000000000000000000000001
10000000100000000000000001000000000000000001
1000000000000000000000000000000000000000001
1000000000000000000000000000000000000000001
1000000000100000000000000000000000000000001
1000000000000000000000000000000000000000001
1000000000000000W00000000000000000000000001
1000000000000000000000000001000000000000001
1000000000000000000010000000000000000000001
1000000000000000000000001000000000000000001
1111111111111111111111111111111111111111111