111111111111
100000000001
101100000001
100100000001
11111111100000001
100000000111111111
N111011110010001
1111011110010001
1100000010010001
1000000000010001
1000000000010001
1100000111110N0111
11110111 1010001 111111