111111111111
100000000001
101100000001
100100000001
11111111100000001
100000000111111111
N111011110010001
1111011110010001
1100000010010001
1000000000010001
1000000000010001
1100000111110N0111
11110111 1010001 111111


        1111111111111111111111111
        1000000000110000000000001
        1011000001110000000000001
        1001000000000000000000001
111111111011000001110000000000001
100000000011000001110111111111111
11110111111111011100000010001
11110111111111011101010010001
11000000110101011100000010001
10000000000000001100000010001
10000000000000001101010010001
11000001110101011111011110N01111111111111
11110111 1110101 101111010001
11111111 1111111 111111111111

  111
  101
  1001
  101
11001
110011
110001111
11 1 1